1 1 1 2 2 2 2 2 2 2 2 2 2 2 2 2 2 1 1 1 1 1 1 1 1 1 1 1 1 1 1 1 1 1 1 1 1 1 1 1 1 1 1 1 1 1 1 2 1 1 
1 17 7 7 7 7 6 6 6 5 5 5 4 4 4 7 6 5 4 7 6 7 4 5 4 5 4 7 5 18 1 1 1 1 1 1 1 1 1 1 1 1 1 1 2 2 2 2 1 1 
1 12 3 3 3 3 3 3 3 3 3 3 3 3 3 3 3 3 3 3 3 3 3 3 3 3 3 3 3 16 1 1 1 1 1 1 1 1 1 1 2 2 2 2 2 1 1 1 1 1 
1 13 3 3 3 3 3 3 3 3 3 3 3 3 3 3 3 3 3 3 3 3 3 3 3 3 3 3 3 16 1 1 1 1 1 2 2 2 2 2 1 1 1 1 1 1 1 1 1 1 
2 20 9 10 10 10 10 9 9 9 9 9 9 9 24 3 3 3 3 3 3 3 3 3 3 3 3 3 3 16 2 2 2 2 2 2 2 2 2 2 2 2 2 1 1 1 1 1 1 1 
2 2 2 2 1 1 1 1 1 2 2 1 1 1 13 3 3 3 3 3 3 3 3 3 3 3 3 3 3 15 1 1 1 1 1 1 1 1 1 1 1 1 2 1 1 1 1 1 1 1 
1 1 1 1 2 2 2 2 2 2 2 2 2 2 12 3 3 3 3 3 3 3 3 3 3 3 3 3 3 15 1 1 1 1 1 1 1 1 1 1 1 2 1 1 1 1 1 1 1 1 
1 1 1 1 1 1 1 1 1 17 6 6 6 6 21 3 3 3 3 3 3 3 3 3 3 3 3 3 3 15 1 1 1 1 1 1 17 5 7 7 7 5 7 7 5 7 5 18 1 1 
1 1 1 1 1 1 1 1 1 13 3 3 3 3 3 3 3 3 3 3 3 3 3 3 3 3 3 3 3 22 7 7 7 7 7 7 21 3 3 3 3 3 3 3 3 3 3 16 1 1 
1 1 1 1 1 1 1 1 1 11 3 3 3 3 3 3 3 3 3 3 3 3 3 3 3 3 3 3 3 3 3 3 3 3 3 3 3 3 3 3 3 3 3 3 3 3 3 16 1 1 
1 1 1 1 1 1 1 1 1 13 3 3 3 3 3 3 3 3 3 3 3 3 3 3 3 3 3 3 3 3 3 3 3 3 3 3 3 3 3 3 3 3 3 3 3 3 3 16 1 1 
1 1 1 1 1 1 1 1 2 11 3 3 3 3 3 3 3 3 3 3 3 3 3 3 3 3 3 3 3 3 3 3 3 3 3 3 3 3 3 3 3 3 3 3 3 3 3 16 1 1 
1 1 1 1 2 2 2 2 1 13 3 3 3 3 3 3 3 3 3 3 3 3 3 3 3 3 3 3 3 3 3 3 3 3 3 3 3 3 3 3 23 8 24 3 3 3 3 16 1 1 
1 1 1 1 2 2 2 2 2 11 3 3 3 3 3 3 3 3 3 3 3 3 3 3 3 3 3 3 3 3 3 3 3 3 3 3 3 3 3 23 19 1 12 3 3 3 3 15 1 1 
1 1 1 17 7 7 7 7 7 21 3 3 3 3 3 3 3 3 3 23 10 9 8 10 8 10 9 10 9 10 9 9 10 9 9 9 9 9 9 19 1 1 12 3 3 3 3 16 1 1 
1 1 1 12 3 3 3 3 3 3 3 3 3 3 3 3 23 9 9 19 1 1 1 2 2 2 2 1 2 1 1 1 2 2 2 1 1 1 1 1 1 1 13 3 3 3 3 15 1 1 
1 1 2 12 3 3 3 3 3 3 3 3 3 3 3 3 15 1 2 2 2 2 2 2 2 2 2 2 2 2 2 2 2 2 2 1 1 1 1 2 2 1 11 3 3 3 3 16 2 2 
1 1 2 12 3 3 3 3 3 3 3 3 3 3 3 23 19 2 2 2 2 2 2 2 2 2 1 1 1 1 2 2 2 2 1 2 2 2 2 1 1 1 13 3 3 3 3 16 1 1 
1 2 1 11 3 3 3 3 3 3 3 3 3 3 3 16 1 2 2 2 2 1 1 1 1 2 1 1 1 1 2 2 2 2 2 1 1 1 1 2 2 2 11 3 3 3 3 15 1 1 
1 2 1 11 3 3 3 3 3 3 3 3 3 3 3 15 2 1 2 1 1 1 1 1 2 2 1 1 2 2 2 2 1 1 2 1 1 2 2 2 2 2 11 3 3 3 3 15 1 1 
1 2 2 11 3 3 3 3 3 3 3 3 3 3 3 14 1 1 1 1 1 1 1 1 2 1 2 2 2 2 1 17 6 6 5 5 6 7 5 5 7 6 21 3 3 3 3 16 1 1 
2 2 2 11 3 3 3 3 3 3 3 3 3 3 3 14 1 1 1 1 1 1 1 2 2 17 5 7 5 5 7 21 3 3 3 3 3 3 3 3 3 3 3 3 3 3 3 16 1 1 
2 2 1 11 3 3 3 3 3 3 3 3 3 3 3 14 1 1 2 2 2 2 2 1 2 13 3 3 3 3 3 3 3 3 3 3 3 3 3 3 3 3 3 3 3 3 23 19 2 1 
2 1 1 11 3 3 3 3 3 3 3 3 3 3 3 14 1 1 1 1 1 1 1 2 2 12 3 3 3 3 3 3 3 3 3 3 3 3 3 3 3 3 3 3 23 10 19 1 1 2 
2 1 1 11 3 3 3 3 3 3 3 3 3 3 3 14 1 1 1 1 1 1 1 1 2 12 3 3 3 3 3 3 3 3 3 23 8 9 10 10 9 9 10 9 19 2 2 1 1 2 
2 1 1 11 3 3 3 3 3 3 3 3 3 3 3 14 1 1 2 2 2 1 1 2 2 12 3 3 3 3 3 3 3 3 3 15 2 2 2 2 1 1 1 1 1 2 2 2 2 1 
1 1 1 11 3 3 3 3 3 3 3 3 3 3 3 15 2 2 2 2 2 2 2 2 2 13 3 3 3 3 3 3 3 3 3 15 1 1 1 1 1 1 1 2 2 2 2 1 2 2 
1 1 1 11 3 3 3 3 3 3 3 3 3 3 3 15 2 2 2 2 2 1 2 1 2 13 3 3 3 3 3 3 3 3 3 16 2 2 2 2 2 2 2 2 2 2 2 2 2 1 
1 1 1 11 3 3 3 3 3 3 3 3 3 3 3 22 6 6 6 6 18 2 2 1 2 20 9 24 3 3 3 3 3 3 23 19 2 2 2 2 2 2 2 2 2 1 1 1 1 1 
1 1 1 20 8 8 8 8 8 8 24 3 3 3 3 3 3 3 3 3 14 1 2 2 2 2 2 20 24 3 3 3 3 3 14 2 1 1 1 2 1 1 2 2 2 2 1 1 1 1 
1 1 1 1 1 1 2 2 1 1 11 3 3 3 3 3 3 3 3 3 14 1 2 2 2 1 2 2 20 24 3 3 3 3 14 2 2 2 2 2 2 2 2 1 1 2 2 1 1 1 
1 1 1 1 1 1 1 2 2 1 13 3 3 3 3 3 3 3 3 3 15 2 1 1 2 2 2 2 1 11 3 3 3 3 15 2 1 2 2 2 1 1 1 1 1 1 2 2 1 1 
2 2 1 1 1 2 2 2 2 2 13 3 3 3 3 3 3 23 9 10 19 2 1 2 2 2 2 2 2 11 3 3 3 3 15 2 2 1 1 1 1 2 2 2 1 1 2 2 2 2 
1 1 1 1 2 2 1 1 1 1 12 3 3 3 3 3 3 16 2 2 2 2 2 2 2 2 2 2 2 13 3 3 3 3 16 2 1 1 1 2 2 1 2 2 1 2 2 1 1 2 
1 1 1 2 2 1 1 1 1 1 13 3 3 3 3 3 3 15 2 2 2 1 2 1 2 2 2 2 1 13 3 3 3 3 16 2 1 1 2 1 1 1 2 1 2 2 1 1 1 2 
1 1 1 2 1 1 1 1 1 1 12 3 3 3 3 3 3 16 2 2 2 2 2 2 2 2 1 2 1 13 3 3 3 3 16 2 2 2 1 1 1 2 1 2 1 1 1 1 1 2 
1 1 1 2 1 1 1 1 1 2 13 3 3 3 3 3 3 14 2 2 2 2 2 2 2 1 17 6 6 21 3 3 3 3 16 2 2 2 2 2 17 7 6 7 4 6 4 7 18 1 
1 1 17 4 4 4 4 4 4 4 30 3 3 3 3 3 3 15 2 2 2 2 2 2 1 1 13 3 3 3 3 3 3 3 16 2 2 2 2 2 12 3 3 3 3 3 3 3 16 1 
1 1 12 3 3 3 3 3 3 3 3 3 3 3 3 3 3 16 2 2 2 1 2 2 2 2 13 3 3 3 3 3 3 3 15 17 5 5 5 5 21 3 3 3 3 3 3 3 16 1 
1 1 12 3 3 3 3 3 3 3 3 3 3 3 3 3 3 14 2 2 2 1 2 1 2 2 12 3 3 3 3 3 3 3 16 12 3 3 3 3 3 3 3 3 3 3 3 3 15 1 
1 1 12 3 3 3 3 3 3 3 3 23 8 10 10 8 8 19 2 2 2 2 2 2 2 2 12 3 3 3 3 3 3 3 16 12 3 3 3 3 3 3 3 3 3 3 3 3 15 2 
1 1 11 3 3 3 3 3 3 3 3 14 2 2 2 2 1 2 2 2 2 2 2 2 2 2 13 3 3 3 3 3 3 3 16 13 3 3 3 3 3 3 3 3 3 3 3 3 14 1 
1 1 12 3 3 3 3 3 3 3 3 15 1 1 1 1 1 2 2 2 2 2 17 7 7 7 21 3 3 3 3 3 3 3 22 21 3 3 3 3 3 3 3 3 3 3 3 3 15 1 
1 1 11 3 3 3 3 3 3 3 3 15 1 1 1 1 2 2 2 2 2 2 12 3 3 3 3 3 3 3 3 3 3 3 3 3 3 3 3 3 3 3 3 3 3 3 3 3 16 1 
1 1 12 3 3 3 3 3 3 3 3 15 2 2 2 2 2 1 1 1 2 1 12 3 3 3 3 3 3 3 3 3 3 3 3 3 3 3 3 3 3 3 3 3 3 3 3 3 14 1 
1 1 13 3 3 3 25 26 27 3 3 16 1 1 2 2 2 2 2 2 2 2 13 3 3 3 3 3 3 3 3 3 3 3 3 3 3 3 3 3 3 3 3 3 3 3 3 3 14 1 
2 2 11 3 3 3 3 3 3 3 3 15 2 2 1 2 2 2 2 1 2 2 13 3 3 3 3 3 3 3 3 3 3 3 3 3 3 3 3 3 3 3 3 3 3 3 3 3 15 2 
1 1 20 8 8 9 10 9 10 10 10 19 1 2 2 2 2 1 1 1 2 2 20 10 9 10 10 9 10 9 9 9 8 9 8 8 8 10 10 10 8 9 8 9 8 9 9 8 19 2 
1 1 2 2 2 2 2 2 2 2 2 2 2 2 2 2 2 2 2 2 2 2 2 2 2 2 2 2 2 2 2 1 1 1 1 2 2 2 2 2 1 2 1 1 1 1 1 1 1 2 
1 1 1 1 1 1 1 1 1 1 1 1 1 1 1 1 1 1 2 2 2 2 2 1 1 1 2 2 2 2 2 2 2 2 1 1 1 1 1 1 1 1 1 1 1 1 1 1 2 1 
