2 2 2 1 1 2 2 2 2 1 2 2 2 2 1 2 2 2 1 2 1 1 2 2 2 1 1 1 1 2 2 2 2 1 2 2 2 1 2 2 1 2 2 1 1 1 2 1 2 1 2 2 2 1 2 2 1 2 2 1 1 1 2 1
2 7 9 10 11 11 10 11 9 9 10 11 9 10 9 11 9 10 10 11 9 10 10 11 9 10 10 11 9 9 11 10 9 10 11 9 10 11 9 10 11 9 10 10 11 9 12 2 1 2 2 2 1 2 2 1 2 2 1 1 1 2 1 2
2 6 3 3 3 3 3 3 3 3 3 3 3 3 3 3 3 3 3 3 3 3 3 3 3 3 3 3 3 3 3 3 3 3 3 3 3 3 3 3 3 3 3 3 3 3 13 2 1 2 2 2 1 2 2 1 2 2 1 1 1 2 1 2
1 5 3 3 3 3 3 3 3 3 3 3 3 3 3 3 3 3 3 3 3 3 3 3 3 3 3 3 3 3 3 3 3 3 3 3 3 3 3 3 3 3 3 3 3 3 14 2 1 2 2 2 1 2 2 1 2 2 1 1 1 2 1 2
1 6 3 3 3 3 3 3 3 3 3 3 3 3 3 3 3 3 3 3 3 3 3 3 3 3 3 3 3 3 3 3 3 3 3 3 3 3 3 3 3 3 3 3 3 3 15 2 1 2 2 2 1 2 2 1 2 2 1 1 1 2 1 2
2 8 18 19 18 17 17 19 18 17 24 3 3 3 3 3 3 3 3 3 3 3 3 3 25 17 17 18 17 19 19 17 18 17 18 19 17 18 24 3 3 3 3 3 3 3 26 10 11 11 9 10 11 10 10 11 9 12 1 1 1 2 1 2
1 1 2 1 2 2 2 1 2 1 4 3 3 3 3 3 3 3 3 3 3 3 3 3 13 1 2 2 2 1 2 1 2 2 2 1 2 1 4 3 3 3 3 3 3 3 3 3 3 3 3 3 3 3 3 3 3 14 1 1 1 2 1 2
1 2 1 1 1 1 2 2 1 2 5 3 3 3 3 3 3 3 3 3 3 3 3 3 14 1 2 1 2 2 2 1 1 2 1 2 2 1 5 3 3 3 3 3 3 3 3 3 3 3 3 3 3 3 3 3 3 13 1 1 1 2 1 1
1 2 2 2 1 2 2 1 2 1 6 3 3 3 3 3 3 3 3 3 3 3 3 3 13 1 1 1 2 2 1 2 1 2 2 1 2 1 6 3 3 3 3 3 3 3 3 3 3 3 3 3 3 3 3 3 3 13 1 1 1 2 1 2
2 1 2 1 2 2 2 1 2 1 4 3 3 3 3 3 3 3 3 3 3 3 3 3 15 2 2 1 2 1 2 1 2 2 1 2 2 1 6 3 3 3 3 3 3 3 3 3 3 3 3 3 3 3 3 3 3 14 1 1 1 2 1 1
1 2 1 1 1 1 2 2 1 2 5 3 3 3 3 3 3 3 3 25 17 18 19 18 16 1 2 1 2 1 2 1 2 2 1 2 1 2 5 3 3 3 3 3 3 3 14 2 1 2 2 2 1 2 2 1 2 14 1 1 1 2 1 1
2 1 2 1 1 1 2 2 1 1 6 3 3 3 3 3 3 3 3 15 2 1 1 1 2 1 1 1 2 2 1 2 1 2 2 1 2 1 3 3 3 3 3 3 3 3 15 2 1 2 2 2 1 2 2 1 2 2 1 1 1 2 1 2
2 2 1 2 1 1 2 1 2 1 6 3 3 3 3 3 3 3 3 13 1 2 2 2 1 2 2 1 2 1 2 1 2 2 1 2 2 1 3 3 3 3 3 3 3 3 15 2 1 2 2 2 1 2 2 1 2 2 1 1 1 2 1 2
1 2 1 1 1 1 2 2 1 2 5 3 3 3 3 3 3 3 3 14 2 2 1 1 2 1 1 1 2 2 1 2 1 2 2 1 2 1 3 3 3 3 3 3 3 3 14 2 1 2 2 2 1 2 2 1 2 2 1 1 1 2 1 1
1 1 2 1 2 2 2 1 2 1 5 3 3 3 3 3 3 3 3 13 1 2 1 2 1 2 2 1 2 1 2 1 2 2 1 2 2 1 3 3 3 3 3 3 3 3 13 2 1 2 2 2 1 2 2 1 2 2 1 1 1 2 1 1
2 1 2 1 2 1 1 2 1 2 4 3 3 3 3 3 3 3 3 14 2 1 1 1 2 1 1 1 2 2 1 2 1 2 2 1 2 1 3 3 3 3 3 3 3 3 15 2 1 2 2 2 1 2 2 1 2 2 1 1 1 2 1 2
2 1 1 2 2 1 2 2 1 2 6 3 3 3 3 3 3 3 3 15 1 2 2 1 2 1 1 1 2 2 1 2 1 2 2 1 2 1 3 3 3 3 3 3 3 3 13 2 1 2 2 2 1 2 2 1 2 2 1 1 1 2 1 2
2 7 9 10 10 11 11 9 10 11 23 3 3 3 3 3 3 3 3 26 10 12 2 2 1 3 3 3 3 3 3 3 3 3 3 3 3 3 3 3 3 3 3 3 3 3 15 2 1 2 2 2 1 2 2 1 2 2 1 1 1 2 1 1
1 5 3 3 3 3 3 3 3 3 3 3 3 3 3 3 3 3 3 3 3 13 3 3 3 3 1 2 2 3 3 3 3 3 3 3 3 3 3 3 3 3 3 3 3 3 14 2 1 2 2 2 1 2 2 1 2 2 1 1 1 2 1 2
2 4 3 3 3 3 3 3 3 3 3 3 3 3 3 3 3 3 3 3 3 14 3 3 3 3 2 2 1 3 3 3 3 3 3 3 3 3 3 3 3 3 3 3 3 3 15 2 1 2 2 2 1 2 2 1 2 2 1 1 1 2 1 2
1 4 3 3 3 3 3 3 3 3 3 3 3 3 3 3 3 3 3 3 3 15 3 3 3 3 2 1 1 3 3 3 3 3 3 3 3 3 3 3 3 3 3 3 3 3 13 2 1 2 2 2 1 2 2 1 2 2 1 1 1 2 1 1
2 5 3 3 3 3 3 3 3 3 3 3 3 3 25 19 17 18 17 19 18 16 3 3 3 3 3 3 3 3 3 3 3 3 3 3 3 3 3 3 3 3 3 3 3 3 15 2 1 2 2 2 1 2 2 1 2 2 1 1 1 2 1 1
2 6 3 3 3 21 20 22 3 3 3 3 3 3 14 1 2 1 2 1 1 2 1 2 1 3 3 3 3 3 3 3 3 3 3 3 3 3 3 3 3 3 3 3 3 3 14 2 1 2 2 2 1 2 2 1 2 2 1 1 1 2 1 2
1 4 3 3 3 3 3 3 3 3 3 3 3 3 13 1 2 2 2 1 2 1 2 1 1 2 3 3 3 3 3 3 3 3 3 3 3 3 3 3 3 3 3 3 3 3 13 2 1 2 2 2 1 2 2 1 2 2 1 1 1 2 1 2
1 5 3 3 3 3 3 3 3 3 3 3 3 3 14 1 2 1 1 1 2 1 2 1 1 2 3 3 3 3 3 3 3 3 3 3 3 3 3 3 3 3 3 3 3 3 15 2 1 2 2 2 1 2 2 1 2 2 1 1 1 2 1 1
2 8 17 18 19 17 18 18 17 19 17 19 19 17 16 2 1 2 1 2 1 1 2 1 1 2 2 1 19 18 18 19 17 19 17 18 18 19 19 19 17 17 18 19 17 18 16 2 1 2 2 2 1 2 2 1 2 2 1 1 1 2 1 1
2 2 2 1 1 2 2 2 2 1 2 2 2 2 1 2 2 2 1 2 1 1 2 2 2 1 1 1 1 2 2 2 2 1 2 2 2 1 2 2 1 2 2 1 1 1 2 2 1 2 2 2 1 2 2 1 2 2 1 1 1 2 1 1
2 2 2 1 1 2 2 2 2 1 2 2 2 2 1 2 2 2 1 2 1 1 2 2 2 1 1 1 1 2 2 2 2 1 2 2 2 1 2 2 1 2 2 1 1 1 2 2 1 2 2 2 1 2 2 1 2 2 1 1 1 2 1 1
2 2 2 1 1 2 2 2 2 1 2 2 2 2 1 2 2 2 1 2 1 1 2 2 2 1 1 1 1 2 2 2 2 1 2 2 2 1 2 2 1 2 2 1 1 1 2 2 1 2 2 2 1 2 2 1 2 2 1 1 1 2 1 1
2 2 2 1 1 2 2 2 2 1 2 2 2 2 1 2 2 2 1 2 1 1 2 2 2 1 1 1 1 2 2 2 2 1 2 2 2 1 2 2 1 2 2 1 1 1 2 2 1 2 2 2 1 2 2 1 2 2 1 1 1 2 1 1
2 2 2 1 1 2 2 2 2 1 2 2 2 2 1 2 2 2 1 2 1 1 2 2 2 1 1 1 1 2 2 2 2 1 2 2 2 1 2 2 1 2 2 1 1 1 2 2 1 2 2 2 1 2 2 1 2 2 1 1 1 2 1 1
2 2 2 1 1 2 2 2 2 1 2 2 2 2 1 2 2 2 1 2 1 1 2 2 2 1 1 1 1 2 2 2 2 1 2 2 2 1 2 2 1 2 2 1 1 1 2 2 1 2 2 2 1 2 2 1 2 2 1 1 1 2 1 1
2 2 2 1 1 2 2 2 2 1 2 2 2 2 1 2 2 2 1 2 1 1 2 2 2 1 1 1 1 2 2 2 2 1 2 2 2 1 2 2 1 2 2 1 1 1 2 2 1 2 2 2 1 2 2 1 2 2 1 1 1 2 1 1
2 2 2 1 1 2 2 2 2 1 2 2 2 2 1 2 2 2 1 2 1 1 2 2 2 1 1 1 1 2 2 2 2 1 2 2 2 1 2 2 1 2 2 1 1 1 2 2 1 2 2 2 1 2 2 1 2 2 1 1 1 2 1 1
2 2 2 1 1 2 2 2 2 1 2 2 2 2 1 2 2 2 1 2 1 1 2 2 2 1 1 1 1 2 2 2 2 1 2 2 2 1 2 2 1 2 2 1 1 1 2 2 1 2 2 2 1 2 2 1 2 2 1 1 1 2 1 1
2 2 2 1 1 2 2 2 2 1 2 2 2 2 1 2 2 2 1 2 1 1 2 2 2 1 1 1 1 2 2 2 2 1 2 2 2 1 2 2 1 2 2 1 1 1 2 2 1 2 2 2 1 2 2 1 2 2 1 1 1 2 1 1